Word:als Layoutprogramm:!&lt;	1((df_fliess_n_u))
Anwendungen:typische:!&lt;	1((df_fliess_n_u))
Layoutprogramme:Word:!&lt;	1((df_fliess_n_u))
Bearbeitung:während Erstellung:!&lt;	1((df_u3))
Bearbeitung:während Erstellung:!&gt;	2((df_fliess))
Bearbeitung:Endbearbeitung:!&lt;	2((df_u3))
Sortierung:Prüfung	2((df_liste_unnum1))
Vollständigkeit:Prüfung	2((df_liste_unnum1))
Ausgewogenheit:Prüfung	2((df_liste_unnum1))
Redundanzen:Prüfung	2((df_liste_unnum1))
Ähnlichkeiten:Prüfung	3((df_liste_unnum1))
Terminologie:Prüfung	3((df_liste_unnum1))
Mehrzahl-Einzahl-Fehler:Prüfung	3((df_liste_unnum1))
Doppeleinträge:Prüfung	3((df_liste_unnum1))
Seitenzahlen:Prüfung	3((df_liste_unnum1))
Bearbeitung:Endbearbeitung:!&gt;	3((df_liste_unnum1))
Bearbeitung:Strukturproblematik beim Embedded Indexing:!&lt;	3((df_u3))
Embedded Indexing:Strukturproblematik:!&lt;	3((df_u3))
Strukturproblematik:!&lt;	3((df_u3))
Fehler:strukturelle:!&lt;	3((df_fliess_n_u))
Vermeidung struktureller Fehler:!&lt;	5((df_u4))
strukturelle Fehler:Vermeidung:!&lt;	5((df_u4))
Fehler:strukturelle:Vermeidung:!&lt;	5((df_u4))
Vermeidung struktureller Fehler:!&gt;	5((df_fliess))
Fehler:strukturelle:Vermeidung:!&gt;	5((df_fliess))
Bearbeitung:Strukturproblematik beim Embedded Indexing:!&gt;	5((df_fliess))
Word:als Layoutprogramm:!&gt;	5((df_fliess))
Layoutprogramme:Word:!&gt;	5((df_fliess))
Fehler:strukturelle:!&gt;	5((df_fliess))
Embedded Indexing:Strukturproblematik:!&gt;	5((df_fliess))
Strukturproblematik:!&gt;	5((df_fliess))
strukturelle Fehler:Vermeidung:!&gt;	5((df_fliess))
Wortfindelisten:Erzeugen:!&lt;	6((df_fliess_n_u_kasten_1vor))
Konkordanzfunktion:!&lt;	6((df_fliess_n_u_kasten_1vor))
AutoMarkierung&lt;kap&gt;	6((df_aufzaehlung_manuell))
Literaturprüfung:mit Konkordanzfunktion:!&lt;	7((df_u3))
Konkordanzfunktion:zur Literaturprüfung:!&lt;	7((df_u3))
Wortfindelisten:Erzeugen:!&gt;	7((df_fliess))
Konkordanzfunktion:!&gt;	7((df_fliess))
Literaturprüfung:mit Konkordanzfunktion:!&gt;	7((df_fliess))
Konkordanzfunktion:zur Literaturprüfung:!&gt;	7((df_fliess))
Registermarken:beim Austausch mit anderen Programmen:!&lt;	8((df_fliess_n_u))
Austausch mit anderen Programmen:!&lt;	8((df_fliess_n_u))
Weiterverarbeitung:Austausch der Registermarken:!&lt;	8((df_fliess_n_u))
Fachbücher:Weiterverarbeitung von Word-Daten	8((df_fliess_n_u))
OpenOffice	8((df_fliess))
LibreOffice	8((df_fliess))
Romane:Spezialprogramme	8((df_fliess))
Sachbücher:Spezialprogramme	8((df_fliess))
Papyrus Autor	8((df_fliess))
InDesign:!&lt;	8((df_u3))
Layoutprogramme:InDesign:!&lt;	8((df_u3))
RTF:InDesign	9((df_tabellenkopf))
InDesign:RTF:!&lt;	9((df_tabellenkopf))
Zwischenablage:InDesign	9((df_tabellenkopf))
InDesign:Zwischenablage:!&lt;	9((df_tabellenkopf))
RTF:InDesign	9((df_tabellenkopf))
Zwischenablage:InDesign	9((df_tabellenkopf))
InDesign:RTF:!&gt;	10((df_tabellentext))
InDesign:Zwischenablage:!&gt;	10((df_tabellentext))
InDesign:Indexeintragsfenster	10((df_bu))
InDesign:Fenster für Spezialsortierung	10((df_bu))
RTF:InDesign	11((df_tabellenkopf))
InDesign:RTF:$&lt;	11((df_tabellenkopf))
Zwischenablage:InDesign	11((df_tabellenkopf))
InDesign:Zwischenablage:$&lt;	11((df_tabellenkopf))
InDesign:RTF:$&gt;	11((df_fliess_n_u))
InDesign:Zwischenablage:$&gt;	11((df_fliess_n_u))
InDesign:!&gt;	11((df_fliess_kasten_nach))
Layoutprogramme:InDesign:!&gt;	11((df_fliess_kasten_nach))
FrameMaker:!&lt;	12((df_u3))
Layoutprogramme:FrameMaker:!&lt;	12((df_u3))
RTF:FrameMaker	12((df_tabellenkopf))
Zwischenablage:FrameMaker	12((df_tabellenkopf))
RTF:FrameMaker	12((df_tabellenkopf))
Zwischenablage:FraneMaker	12((df_tabellenkopf))
Semikolon:bei FrameMaker	13((df_fliess))
eckige Klammern:bei FrameMaker	14((df_fliess))
Klammern:eckige und spitze bei FrameMaker	14((df_fliess))
spitze Klammern:bei FrameMaker	14((df_fliess))
FrameMaker:!&gt;	14((df_fliess_kasten_nach))
Layoutprogramme:FrameMaker:!&gt;	14((df_fliess_kasten_nach))
Rückkonvertierung:!&lt;	14((df_u3))
Textrahmenproblem:!&lt;	14((df_u3))
Layouts:Unterschied zwischen einfachen und komplexen	14((df_fliess_n_u))
Fachbücher:Rückkonvertierung	14((df_fliess_kasten_1vor))
Rückkonvertierung:!&gt;	15((df_fliess_kasten_nach))
Textrahmenproblem:!&gt;	15((df_fliess_kasten_nach))
Index:mit Seitenzahlen des Layoutprogramms:!&lt;	15((df_u3))
Seitenzahlen:des Layoutprogramms:!&lt;	15((df_u3))
Layoutprogramm:Seitenzahlen:!&lt;	15((df_u3))
Fachbücher:Indexing in Word mit Seitenzahlen des Layoutprogramms	15((df_fliess_kasten_1vor))
Mulvany, Nancy:Indexing in Word mit Seitenzahlen des Layoutprogramms	16((df_fliess_kasten_1vor))
Index:mit Seitenzahlen des Layoutprogramms:!&gt;	17((df_fliess))
Seitenzahlen:des Layoutprogramms:!&gt;	17((df_fliess))
Layoutprogramm:Seitenzahlen:!&gt;	17((df_fliess))
OpenOffice:!&lt;	17((df_u3))
LibreOffice:!&lt;	17((df_u3))
ODT	17((df_fliess_n_u))
Austauschformate:mit OpenOffice/LibreOffice	17((df_liste_unnum1))
OpenOffice:Austauschformate	17((df_liste_unnum1))
LibreOffice:Austauschformate	17((df_liste_unnum1))
Code-Verschiebung:OpenOffice/LibreOffice	18((df_fliess))
OpenOffice:!&gt;	21((df_fliess))
LibreOffice:!&gt;	21((df_fliess))
Papyrus Autor:!&lt;	21((df_u3))
Registermarken:beim Austausch mit anderen Programmen:!&gt;	21((df_liste_unnum1))
Austausch mit anderen Programmen:!&gt;	21((df_liste_unnum1))
Weiterverarbeitung:Austausch der Registermarken:!&gt;	21((df_liste_unnum1))
Papyrus Autor:!&gt;	21((df_liste_unnum1))
PDF-Indexe:!&lt;	21((df_fliess_n_u))
AutoBookmark (Acrobat-Plugin):!&lt;	22((df_fliess))
PDF-Indexe:!&gt;	23((df_fliess))
AutoBookmark (Acrobat-Plugin):!&gt;	23((df_fliess))
E-Book-Indexe:!&lt;	23((df_fliess_n_u))
Funktionalität:eines Index	23((df_fliess_n_u))
Aktivität:von Einträgen	23((df_fliess_n_u))
funktionaler E-Book-Index	24((df_fliess_kasten_1vor))
E-Book-Indexe:funktionale	24((df_fliess_kasten_1vor))
E-Book-Indexe:mit aktiven Seitenzahlen	24((df_fliess_kasten_1vor))
E-Book-Indexe:Sinn:!&lt;	24((df_u3))
Volltextsuche:Kritik	24((df_fliess))
Fundlisten:auf E-Book-Readern	24((df_fliess))
E-Book-Reader:Fundlisten	24((df_fliess))
E-Book-Indexe:Sinn:!&gt;	25((df_fliess))
E-Book-Indexe:Erzeugung:!&lt;	25((df_u3))
HTML:bei E-Book-Erzeugung	25((df_fliess_n_u))
EPUB	25((df_fliess_n_u))
MOBI	25((df_fliess_n_u))
Jutoh:E-Book-Erzeugung	25((df_fliess_n_u))
KompoZer	25((df_fliess_n_u))
Calibre (E-Book-Erzeugungs- und Verwaltungsprogramm)	25((df_fliess_n_u))
E-Book-Erzeugungsprogramme:Calibre	25((df_fliess_n_u))
E-Book-Verwaltungsprogramme:Calibre	25((df_fliess_n_u))
Sigil (EPUB-Programm)	25((df_fliess_n_u))
EPUB-Programme:Sigil	25((df_fliess_n_u))
E-Book-Erzeugung:indirekter Weg	25((df_aufzaehlung))
E-Book-Erzeugung:direkter Weg	25((df_aufzaehlung))
Verlinkung der Seitenzahlen:bereits in Word:!&lt;	25((df_u4))
Seitenzahlen:Verlinkung direkt in Word:!&lt;	25((df_u4))
Links:Erzeugung in Word:!&lt;	25((df_fliess_kasten_1vor))
Hyperlinks:Erzeugung in Word:!&lt;	25((df_fliess_kasten_1vor))
Verlinkung der Seitenzahlen:in E-Book-Programmen	26((df_fliess_n_u))
E-Book-Programme:Verlinkung der Seitenzahlen	26((df_fliess_n_u))
Calibre (E-Book-Erzeugungs- und Verwaltungsprogramm)	26((df_fliess_n_u))
E-Book-Erzeugungsprogramme:Calibre	26((df_fliess_n_u))
E-Book-Verwaltungsprogramme:Calibre	26((df_fliess_n_u))
Sigil:Indexfunktion	26((df_fliess))
Jutoh:Indexfunktion	26((df_fliess))
Links:Erzeugung in Word:!&gt;	26((df_fliess))
Hyperlinks:Erzeugung in Word:!&gt;	26((df_fliess))
automatische Verlinkung:Seitenzahlen	26((df_u4))
Verlinkung der Seitenzahlen:automatische	26((df_u4))
Seitenzahlen:automatische Verlinkung	26((df_u4))
IndexLinker	26((df_fliess_n_u))
Mustererkennung:zur Seitenzahlverlinkung	26((df_fliess))
Online-Tool:zur Indexerzeugung	27((df_fliess))
Indexerzeugung (Gesamtindex):per Online-Tool	27((df_fliess))
Perl:zur Indexerzeugung	27((df_fliess))
Python:zur Indexerzeugung	27((df_fliess))
Verlinkung der Seitenzahlen:bereits in Word:!&gt;	27((df_fliess))
Seitenzahlen:Verlinkung direkt in Word:!&gt;	27((df_fliess))
Verlinkung der Seitenzahlen:bei Weiterverarbeitung:!&lt;	27((df_u4))
Seitenzahlen:Verlinkung bei Weiterverarbeitung:!&lt;	27((df_u4))
InDesign:Verlinkung von Seitenzahlen:!&lt;	27((df_fliess))
InDesign:Verlinkung von Seitenzahlen:!&gt;	28((df_bu))
FrameMaker:Verlinkung von Indexdaten	28((df_fliess))
Jutoh:Verlinkung von Indexdaten:!&lt;	28((df_fliess))
Code-Verschiebung:Übergabe der Seitenzahlinformation an Jutoh	29((df_fliess_n_u))
Jutoh:E-Book-Index mit aktiven Seitenzahlen	29((df_fliess_n_u))
Jutoh:Verlinkung von Indexdaten:!&gt;	29((df_fliess_n_u))
Seitenzahlen:Mix aus manueller und automatischer Verlinkung	29((df_u4))
Verlinkung der Seitenzahlen:Mix aus manueller und automatischer	29((df_u4))
manuelle Seitenzahlverlinkung:Mix mit automatischer Verlinkung	29((df_u4))
automatische Seitenzahlverlinkung:Mix mit manueller Verlinkung	29((df_u4))
InDesign:Verlinkung von Seitenzahlen:$	29((df_fliess))
Jutoh:Mix aus manueller und automatischer Verlinkung	29((df_fliess))
Zielgenauigkeit der Indexverlinkung:!&lt;	30((df_u4))
Indexverlinkung:Zielgenauigkeit:!&lt;	30((df_u4))
Verlinkung der Seitenzahlen:Zielgenauigkeit:!&lt;	30((df_u4))
XE-Felder:Platzierung:punktgenaue	30((df_fliess))
Sprunganker:Einbau	30((df_fliess))
Sprunggenauigkeit:!&lt;	30((df_fliess_kasten_1vor))
Coe, Mary:Sprunggenauigkeit	30((df_fliess_kasten_1vor))
Wright, Jan:Sprunggenauigkeit	30((df_fliess_kasten_1vor))
PDF-Dateien:Umwandlung in EPUB	30((df_fliess))
EPUB:aus PDF	30((df_fliess))
Verlinkung der Seitenzahlen:bei Weiterverarbeitung:!&gt;	31((df_fliess))
Seitenzahlen:Verlinkung bei Weiterverarbeitung:!&gt;	31((df_fliess))
Zielgenauigkeit der Indexverlinkung:!&gt;	31((df_fliess))
Indexverlinkung:Zielgenauigkeit:!&gt;	31((df_fliess))
Verlinkung der Seitenzahlen:Zielgenauigkeit:!&gt;	31((df_fliess))
Sprunggenauigkeit:!&gt;	31((df_fliess))
E-Book-Indexe:Erzeugung:!&gt;	31((df_fliess))
E-Book-Indexe:ideale:!&lt;	31((df_u3))
EPUB Indexes Work Group (IWG)	31((df_fliess))
Indexes Work Group (IWG)	31((df_fliess))
IWG (EPUB Indexes Work Group)	31((df_fliess))
International Digital Publishing Forum (IDPF)	31((df_fliess))
IDPF (International Digital Publishing Forum)	31((df_fliess))
Brown, Glenda:idealer E-Book-Index	31((df_fliess))
Combs, Michele:idealer E-Book-Index	31((df_fliess))
Wright, Jan:idealer E-Book-Index	31((df_fliess))
Navigationsbereich:im E-Book-Index	31((df_aufzaehlung))
Anzeige eines E-Book-Indexes:Detailgrad	31((df_aufzaehlung))
E-Book-Indexe:Detailgrad der Anzeige	31((df_aufzaehlung))
Popup-Fenster:in E-Book-Index:!&lt;	31((df_aufzaehlung))
Popup-Fenster:in E-Book-Index:!&gt;	31((df_aufzaehlung))
Metadaten:zu Fundstellen	32((df_aufzaehlung))
